0  0  0  0  0  0  0  0  0  0  0  0  0  0  0  0  0  0  0
0  0  0  0  0  0  0  0  0  0  0  0  0  0  0  0  0  0  0
0  0 10 10  0  0 10 10  0  0  0 25 25 25 25 25  0  0  0
0  0 10 10  0  0 10 10  0  0  0  0  0  0  0 25 25  0  0
0  0 10 10  0  0 10 10  0  0  0  0  0  0  0 25 25  0  0
0  0 10 10 10 10 10 10  0  0  0  0 25 25 25 25  0  0  0
0  0  0 10 10 10 10 10  0  0  0 25 25  0  0  0  0  0  0
0  0  0  0  0  0 10 10  0  0  0 25 10  0  0  0  0  0  0
0  0  0  0  0  0 10 10  0  0  0 25 25 25 25 25 25  0  0
0  0  0  0  0  0  0  0  0  0  0  0  0  0  0  0  0  0  0
0  0  0  0  0  0  0  0  0  0  0  0  0  0  0  0  0  0  00  0  0  0  0  0  0  0  0  0  0  0  0  0  0  0  0  0  0
                                                       0  0  0  0  0  0  0  0  0  0  0  0  0  0  0  0  0  0  0
                                                       0  0 35 35  0  0 35 35  0  0  0 45 45 45 45 45  0  0  0
                                                       0  0 35 35  0  0 35 35  0  0  0  0  0  0  0 45 45  0  0
                                                       0  0 35 35  0  0 35 35  0  0  0  0  0  0  0 45 45  0  0
                                                       0  0 35 35 35 35 35 35  0  0  0  0 45 45 45 45  0  0  0
                                                       0  0  0 35 35 35 35 35  0  0  0 45 45  0  0  0  0  0  0
                                                       0  0  0  0  0  0 35 35  0  0  0 45 45  0  0  0  0  0  0
                                                       0  0  0  0  0  0 35 35  0  0  0 45 45 45 45 45 45  0  0
                                                       0  0  0  0  0  0  0  0  0  0  0  0  0  0  0  0  0  0  0
                                                       0  0  0  0  0  0  0  0  0  0  0  0  0  0  0  0  0  0  0
